 /--------------------------------------\  /--------------------------------------\ 
 |  .  .  .  .  .  .  .  .  .  .  .  .  |  |  .  .  .  .  .  .  .  .  .  .  .  .  | 
 |  .  /--------\  .  /-----------\  .  |  |  .  /-----------\  .  /--------\  .  | 
 |  *  |        |  .  |           |  .  |  |  .  |           |  .  |        |  *  | 
 |  .  \--------/  .  \-----------/  .  \--/     \-----------/  .  \--------/  .  | 
 |  .  .  .  .  .  .  .  .  .  .  .  .  .  .  .  .  .  .  .  .  .  .  .  .  .  .  | 
 |  .  /--------\  .  /--\  .  /--------------------\  .  /--\  .  /--------\  .  | 
 |  .  \--------/  .  |  |  .  \--------\  /--------/  .  |  |  .  \--------/  .  | 
 |  .  .  .  .  .  .  |  |  .  .  .  .  |  |  .  .  .  .  |  |  .  .  .  .  .  .  | 
 \--------------\  .  |  \--------\  .  |  |  .  /--------/  |  .  /--------------/ 
                |  .  |  /--------/  .  \--/  .  \--------\  |  .  |                
                |  .  |  |                                |  |  .  |                
                |  .  |  |     /-------      -------\     |  |  .  |                
----------------/  .  \--/     |                    |     \--/  .  \----------------
 A                 .           |                    |           .                 B 
----------------\  .  /--\     |                    |     /--\  .  /----------------
                |  .  |  |     \--------------------/     |  |  .  |                
                |  .  |  |                                |  |  .  |                
                |  .  |  |     /--------------------\     |  |  .  |                
 /--------------/  .  \--/     \--------\  /--------/     \--/  .  \--------------\ 
 |  .  .  .  .  .  .  .  .  .  .  .  .  |  |  .  .  .  .  .  .  .  .  .  .  .  .  | 
 |  .  /--------\  .  /-----------\  .  |  |  .  /-----------\  .  /--------\  .  | 
 |  *  \-----\  |  .  \-----------/  .  \--/  .  \-----------/  .  |  /-----/  *  | 
 |  .  .  .  |  |  .  .  .  .  .  .  .  .  .  .  .  .  .  .  .  .  |  |  .  .  .  | 
 \-----\  .  |  |  .  /--\  .  /--------------------\  .  /--\  .  |  |  .  /-----/ 
 /-----/  .  \--/  .  |  |  .  \--------\  /--------/  .  |  |  .  \--/  .  \-----\ 
 |  .  .  .  .  .  .  |  |  .  .  .  .  |  |  .  .  .  .  |  |  .  .  .  .  .  .  | 
 |  .  /--------------/  \--------\  .  |  |  .  /--------/  \--------------\  .  | 
 |  .  \--------------------------/  .  \--/  .  \--------------------------/  .  | 
 |  .  .  .  .  .  .  .  .  .  .  .  .  .  .  .  .  .  .  .  .  .  .  .  .  .  .  | 
 \--------------------------------------------------------------------------------/ 
